################################################################################
#A      #                                                                      #
# ##### # ############################### #################################### #
#     # #       #                 #      #                                     #
##### # ####### # ########### ##### #### # ################################### #
#     #       # #         #     #      # #                                    B#
# ####### ### # ######### ##### ######## # ################################### #
#         #   # #         #              #                                     #
######### ##### # ######## ################ ################################## #
#         #     #        #                #                                    #
# ######### ##### ######## ################ ###############################   ##
#               #                      #                                       #
################# ####################### ###################################  #
#                             #                                                #
# ########################### ################################################ #
#                   #                     #                                    #
# ################# # ################### ###################################  #
#                 # #                   #                                      #
# ########### ### # ######### ######### ################################### ## #
#               #   #       #                                                  #
# ################# # ##### #################################################  #
#                   #                                                          #
################################################################################
